EA ./texture/greystone.xpm
NO  ./texture/frog.xpm
SO  ./texture/ayman.xpm
WE   ./texture/24.xpm

F 220,100,43
C  10,5,5


111111111
100000001
100000001
100000001
100000001
100000001
100010001
100000001
101D00001
100000001
100000101
100N00001
100000001
111111111
